1111011111111
1001000000C01
1000011111001
10P011E000001
1111111111111