11111111111
10XX000X001
1P00E00X001
1C00000C011
11111111111