11111111111
10XX000X001
1P00000X001
1C00E00C001
11111111111