111111111111111111
1000010000000000001
1010000001110100001
101000E000000C01001
101000P0000C00C0001
1111111111110111111