1111111111111111111
1000010000000000001
1010000001110100001
1010000000000001001
101000000PC00000001
1000000000P00000001
1111111111111111111