1111111111111111111
1000010000000000001
1010000001110100001
10100E0000000C01001
101000000PC00C00001
100000000P000000001
1111111111111111111