11111111111
10000000001
1C000000001
1E0000P0001
11111111111