1111111111111111111
1E000100000C0000001
1110000001111000001
1P10000000000001001
1010000000000000001
1000000000000000001
1111111111111111111