1111111111111111111
1000010000000000001
101000000111E100001
1010000000000001001
10100000P0000000001
10000000C0000000001
1111111111111111111